N
10, 10
C
5
R
1, 1
T
3, 10
2, 10
1, 10
2, 10
3, 10
2, 10
1, 10
2, 10
3, 10
4, 10
5, 10
6, 10
7, 10
8, 10
9, 10
10, 10
9, 10
8, 10
7, 10
6, 10
5, 10
4, 10
3, 10
2, 10
1, 10
2, 10
3, 10
4, 10
5, 10
M
1, 1, 1, 1, 9, 1, 1, 1, 1, 1
1, 1, 1, 9, 9, 1, 1, 1, 1, 1
1, 1, 1, 9, 9, 1, 1, 1, 1, 1
1, 1, 1, 9, 9, 1, 1, 1, 1, 1
1, 1, 1, 9, 9, 1, 1, 1, 1, 1
1, 1, 1, 9, 9, 1, 1, 1, 1, 1
1, 1, 1, 9, 9, 1, 1, 1, 1, 1
1, 1, 1, 9, 9, 1, 1, 1, 1, 1
1, 1, 1, 9, 9, 1, 1, 1, 1, 1
1, 1, 1, 1, 1, 1, 1, 1, 1, 1
