N
10, 10
C
1, 1, 1, 1, 9, 1, 1, 1, 1, 1
1, 1, 1, 9, 9, 1, 1, 1, 1, 1
1, 1, 1, 9, 9, 1, 1, 1, 1, 1
1, 1, 1, 9, 9, 1, 1, 1, 1, 1
1, 1, 1, 9, 9, 1, 1, 1, 1, 1
1, 1, 1, 9, 9, 1, 1, 1, 1, 1
1, 1, 1, 9, 9, 1, 1, 1, 1, 1
1, 1, 1, 9, 9, 1, 1, 1, 1, 1
1, 1, 1, 9, 9, 1, 1, 1, 1, 1
1, 1, 1, 1, 1, 1, 1, 1, 1, 1
