N
10, 10
C
8, 1, 1, 1, 9, 1, 1, 1, 1, 1
1, 1, 1, 9, 9, 1, 1, 1, 1, 1
1, 1, 1, 9, 9, 1, 1, 1, 1, 1
1, 1, 1, 9, 9, 1, 1, 1, 1, 1
1, 1, 1, 9, 9, 1, 1, 1, 1, 1
1, 1, 1, 9, 9, 1, 1, 1, 1, 1
1, 1, 1, 9, 9, 1, 1, 1, 1, 1
1, 1, 1, 9, 9, 1, 1, 1, 1, 1
1, 1, 1, 9, 9, 1, 1, 1, 1, 1
1, 1, 1, 1, 1, 1, 1, 1, 1, 1
